Высота	740
Ширина	700
Длина	1100
Вес (кг)	22.2
Тип мебели	Стол обеденный
Форма	овальный
Тон основной	Светлый
Модель	Триумф 1
Производитель	Sitparad
Страна	Россия
Угол поворота	Отсутствует
Цвет основной	Белый/Нет/Светлый
Материал основной	ЛДСП/Пластик
Изготовлено из дерева	Нет
Материал корпуса	Металл
Корпус из древесины	Нет
Цвет корпуса	Хром/Нет/Светлый
Отделка основная	нет
Вид ножек	Стационарные
Вид трансформации столешницы	раздвижная
Высота после трансформации	740
Ширина после трансформации	700
Длина после трансформации	1420