Характеристики:

Основные
:
Тип	Шкаф

Форма шкафа  	прямой

Форма фасада  	прямой

Количество дверок	1 (шт.)

Количество выдвижных ящиков	3 (шт.)

Производитель  	Мебель-Сервис

Страна производитель	Украина

Гарантийный срок  	12 (мес)

Состояние	Новое


Материал изготовления
:
Корпус  	ламинированная ДСП

Фасады  	ЛДСП в МДФ профиле

Габаритные размеры шкафа:

Ширина шкафа	500.0 (мм)

Высота шкафа	2180.0 (мм)

Глубина шкафа	377.0 (мм)