Характеристики:

Основные
:

Производитель  	Мебель-Сервис

Страна производитель	Украина

Тип шкафа	линейный (прямой)

Тип фасада шкафа	распашной

Количество створок (дверей)	2 (шт.)

Форма фасада	прямой

Количество внешних выдвижных ящиков	3 (шт.)

Наличие зеркала	на внешней стороне фасада

Количество зеркал	1 (шт.)

Гарантийный срок  	12 (мес)

Состояние	Новое
Габаритные размеры шкафа:

Ширина шкафа	900.0 (мм)

Глубина шкафа	565.0 (мм)

Высота шкафа	2180.0 (мм)


Материал изготовления шкафа:


Корпус	ламинированная ДСП

Фасады  	ЛДСП в МДФ профиле

